you know during the season and i guess at at your level uh you lose them to the next level if if they decide to recall the the parent team the Braves decide to call to recall a guy from triple A then a double A guy goes up to replace him and a single A guy goes up to replace him	You lose the things to the following level if the people recall.
One of our number will carry out your instructions minutely.	A member of my team will execute your orders with immense precision.
How do you know? All this is their information again.	This information belongs to them.
my walkman broke so i'm upset now i just have to turn the stereo up real loud	I'm upset that my walkman broke and now I have to turn the stereo up really loud.
(Read  for Slate 's take on Jackson's findings.)	Slate had an opinion on Jackson's findings.
I burst through a set of cabin doors, and fell to the ground-	I burst through the doors and fell down.
Issues in Data Synthesis.	Problems in data synthesis.
well you see that on television also	You can see that on television, as well.
We sought to identify practices that were commonly implemented by the agencies within the past 5 years.	We want to identify practices commonly used by agencies in the last 5 years
The other men shuffled.	The other men were shuffled around.
well it's been very interesting	It has been very intriguing.
He started slowly back to the bunkhouse.	He returned slowly to the bunkhouse.
Postal Service were to reduce delivery frequency.	The postal service could deliver less frequently.
And in another shift in the economy, it was found that lamb could be raised more cost-effectively on lowland farms in part because of the richer, more nutritious grazing land available there and as a result Lakeland farms became less profitable.	Another shift in the economy was found to be more nutritious.
The rule contains information collection requirements which will allow EPA to determine that detergent additives which are effective in controlling deposits are used and that emission control goals are realized.	The rule has data collection requirements which aid the EPA to realize their emission control goals.
In the crypt are interred the remains of Voltaire and Rousseau, Hugo and Zola, assassinated Socialist leader Jean Jaurys, and Louis Braille, the inventor of the alphabet for the blind.	The remains of Voltaire and Rousseau, Hugo and Zola, assassinated Socialist leader Jean Jaurys, and Louis Braille are all interred in the crypt.
there's a uh a couple called um oh i'm going to forgot his name now uh Dirkson	I can't remember their name
And to show just how fast Japan's new rulers were catching on, two punitive expeditions were launched against Korea and China in the grand manner of 19th-century gunboat diplomacy.	Japan's new rulers were catching on quickly.
These organizations invest the time and effort to understand their processes and how those processes contribute to or hamper mission accomplishment.	These organizations invest lots of time to understand how some processes can contribute to or haampe
You have access to the facts. 	The facts are accessible to you.
Build environment Engineering Manufacturing Production (all rate tooling) (1st set of production tooling)	It is the first set of production tooling for manufacturing.
According to the Office of the Actuary at the Health Care Financing Administration, the estimated net present value of future additional resources needed to fund HI benefits alone over the 75 years is $4.	The net present value of future additional resources for funding HI benefits was $4.
Thus, with respect to the litigation services Congress has funded, there is no alternative channel for expression of the advocacy Congress seeks to restrict.	This is the only channel of expression of the advocacy that Congress seeks to restrict.
How do we fix this?'	Can we fix this?
Take a remarkable statistic that Shesol cites but lets pass relatively unexamined.	They had data that was very relevant but under used.
Get individuals to invest their time and the funding will follow.	If individuals will invest their time, funding will come along, too.
We stink all the time.	We always stink.
The rule requires broadcasters to maintain a file for public inspection containing a Children's Television Programming Report and to identify programs specifically designed to educate and inform children at the beginning of those programs and to furnish such information to the publishers of program guides.	The rule makes broadcasters keep a file about children's television programming.
Just as the Daily Worker and New Masses , socialist papers from the 1930s, were peppered with citations of Marx and Engels, Educational Liberator is peppered with references to their libertarian equivalents--Friedrich Hayek and Ludwig von Mises.	Citations from Marx were used in socialist papers in the 30s. 
I'm not into this Multivista stuff, because what is some dumpy system when compared to a beautiful hyperextension of the sun somewhere over Kuchara, when compared to the golden hue of onion fried with the kse-fi waves, when compared to the number of dividers for credit membranes in a wallet of a rich man, when compared to the magnificent smell of a briessante roll dunked in wholesome milk synthetically enriched with substances boosting the secretion of happiness hormones, that one from two years ago, not three,' Gonzo said in a tone characteristic for a man who just discovered a solution to his life problem.	He's not into this multivista stuff because what is some dumpy system compared to the magnificent smell of a cinnamon roll dunked in wholesome milk.
Clark also expressed the hope that he and Redgrave could continue with their marriage.	Clark hoped that he could continue their marriage.
The fourth-century Roman emperor Gratianus was an early visitor, followed much later by such luminaries as the Romantic poet Alphonse de Lamartine, Queen Victoria, Saint-Sa?芦ns, and Rachmaninov.	Gratianus was a Roman empoeror.
So, I went to court by myself and told them the truth, but it didn't do me any good.	I went and told the truth at court but it didn't do me any good.
no oh no oh well take care	Bye for now.
how can you prove it	Can you tell me how to prove it?
According to this executive, the town hall meetings helped improve his customer satisfaction levels because veterans identified the concerns that were most important to them, gained direct access to the VBA employees working on their benefit claims, and were better able to understand the claims process.	The own hall meetings helped improve his customer satisfaction levels, said the executive.
The  With attorneys one year out of graduate school facing an average debt of just less than $90,000 and starting salaries at legal aid organizations averaging $31,000, they couldn't afford the job.	New attorneys have massive law school debt.
Here you'll see a shrunken head, a two-headed goat, and a statue of Marilyn Monroe made of shredded money, among other curiosities.	One of the curiosities is a two-headed goat.
He mostly hangs out with a group of older, Southern black men, who call him Jumper and Black Cat.	The group of guys he tends to hang out with gave him the nickname Jumper.
right right well it's it's a beautiful city and but the problem is like first example when i was young they they took me to Las Vegas and that was the most boring place on earth	I think Las Vegas is the most boring place I know.
'Less loud.	Please be quiet.
i'm going to be able to make my own clothes	I will be able to make my own clothing.
The river plays a central role in all visits to Paris.	The river is central to all vacations to Paris.
they're supposed to be bilingual	They're supposed to be bilingual 
In any case--it's over."  	It is over.
Critical to the product development process were activities that enabled the capture of specific design and manufacturing knowledge and decision reviews to determine if the knowledge captured would support the increased investment necessary to move to the next development phase or into production.	The knowledge captured would determine if the next step was further development or production.
Said I was foolishly proud. 	My pride was foolish not well placed.
The word had filled his head as though the girl had whispered directly into both ears.	The girl spoke very quietly. 
and a lot of their rules and regulations aren't real clear so we have our manager of environmental who assist the TACB which is located in Austin in writing and hey look what we've done here at TI	There rules are not really clear so we ask our manager for help.
yeah it's kind of like in Louisiana where that uh guy that's like a Ku Klux Klan member something got elected  kind of scary when you think about that	A Ku Klux Klan member has been elected in Louisiana.
or at least they try and do something about it first	They might at least try and do something about it first.
i i'm i'm not really impressed with i mean i lived in Germany for three years i i was i'm not impressed with skiing now i like i like other you know winter sports but i'm not real thrilled about them	I am not a big fan of winter sports.
It's a commitment to general education--a sequence of courses intended to develop critical thinking in a wide variety of disciplines--in opposition to early specialization.	General education's focus is to develop students' critical thinking skills.
Collaboration with rigorous methodologists is important, but those collaborations have to focus on what can be accomplished specifically in the ED setting.	Working with rigorous methodologists is important.
but then we started watching it and and like the new ones are pretty cool because because they got like uh like special like especially things that like fuck with your mind	The new ones have things that can fuck with your mind.
In 2000, GNP was less than GDP because income receipts from the rest of the world were less than U.S. payments to the rest of the world.	The US paid more to the rest of the world than the rest of the world received in income.
Have you any tips to give us before we clear out?"	Anything we should know?
Races are held between April and December at the Veliefendi Hippodrome near Bakerky, 15 km (9 miles) west of Istanbul.	There are races from April to December at Veliefendi Hippodrome.
uh it's but then there's so many people you get so many different opinions like well you shouldn't have well i shouldn't have to have to do this or i shouldn't have to do that and all this other stuff i don't want to get involved and	Opinions tend to vary.
To be sure that any needlework item is the genuine article (as opposed to an inferior import or machine-made piece), look for a lead seal with an M, the emblem of IBTAM meaning it's been certified by the Instituto de Bordado, Tapecaras e Arte?颅sanato da Madeira (Institute of Madeiran Embroidery, Tapestry, and Handicrafts), an official island organization that has a showroom/museum on Rua Visconde de Anadia, 44.	There is a seal to show authenticity. 
It will be a pleasure dressing Jane.	Dressing Jane will be enjoyable.
In applying this requirement, the following factors may influence the auditors' assessment of control 	The influence of the following factors is possible.
do they live close by	Is their house near here?
Now conservatives are fighting back.	Conservatives are battling now.
There are good road connections between Sant Antoni and both CaleT?隆rida and CaleBadella, with the result that both bays have now been developed.	With the good road connections, both bays have been developed.
and if you yeah if you want to so at least you you know you wouldn't have any surprises you can order any type of you know service you want but you stand a good chance you know having to pick up at least part of the bill yourself	You may have to foot the bill if you order any service you want.
Really, Sir Ernest, protested the judge, "these questions are not relevant." Sir Ernest bowed, and having shot his arrow proceeded. 	Sir Ernest bent his head slightly, and continued.
Fiction has its glories, but concealment is merely squalid.	Hiding things is just dirty, whereas there is glory in fiction
Hopefully, Wall Street will take voluntary steps to address these issues before it is forced to act.	Wall Street is facing issues, that need to be addressed. 
okay pro football i like two teams one the New York Giants and the second is the Raiders	The New York Giants and Raiders are my favorite teams in football.
uh stick on those things and they can just all that's all they have to do i mean that wouldn't cost a great deal of money and uh	It wouldn't cost them much money to just stick on those things.
On the mainland, an invasion of even greater significance followed in 1580, when Philip II of Spain proclaimed himself king of Portugal and marched his armies across the border.	Philip II of Spain invaded Portugal.
yeah well i'm well i'm definitely for it	I am certainly in agreement with it.
I tipped it upside down.	I turned it over.
Lorenzo the Magnificent and brother Giuliano lie in simple tombs beneath the sculptor's Madonna and Child, flanked by lesser artists' statues of the family patron saints Cosmas and Damian.	Lorenzo and Giuliano were related to one another.
It has a staff of about 100 employees, including attorneys and support staff, in 10 branch offices.	The 10 branches had close to 100 employees.
All we've done is checked that the first two creditors divided their collective share of $125 appropriately	The first two creditors divided their shares correctly.
However, little evidence remains of that era some ceramics in the museum, a few fortifications, a network of irrigation ditches.	There is little evidence left of that era.
, chief knowledge officers or chief technical officers) that diffuse responsibility across several senior-level managers.	Chief officers often spread their responsibility among senior-level managers. 
The smart Annie was not in evidence.	The clever Annie was not in proof.
At the heart of the sanctuary, a small granite shrine once held the sacred barque of Horus himself.	Horus has a shrine.
Postal Service's domestic rates for First-Class and Priority Mail to the inbound mail distribution described above.	Usps domestic rates for priority and first class mail ate described above. 
Unbar, Francisco! he called in Spanish.	He call Francisco in Spanish.
The Commission is unwilling to recommend an interpretation of the statute that produces such consequences, absent an express congressional intent that such burdens be imposed.	Unless congress expresses an intent that such burdens be imposed, the Commission is unwilling to recommend an interpretation of the statute that produces such consequences.
The New York Times ' Janet Maslin says the film works precisely because it is derivative--its stars, Matt Dillon and Gary Sinise, emulate the characters in The Usual Suspects , which gives them extraordinary opportunities to preen.	The movie stars Matt Dillon and Gary Sinise.
probably so probably so um-hum	probably yes so uh-huh
well they all come back from from the bottom	They bounce back from the bottom.
Just a hunch.	It is just a guess
The SPAN  A Guide to Legal Services Planning.	The SPAN A guide is a guide used for legal service planning.
yeah i think they did a pretty good job but  they didn't follow it exactly but they did give it you know do it justice	They made a good rendition.
The Citizens of the United States of America have a right to applaud themselves for having given to mankind examples of an enlarged and liberal  a policy worthy of imitation.	The citizens of the U.S. are supposed to be proud of themselves.
She always says the right thing, does the right thing, wears the right clothes.	She does, says, and wears everything perfectly, consistently. 
Leave the river briefly to loop east around Talcy, with its Romanesque church and the 13th-century chateau of Thizy, before ending your trip at Montr??al.	It is recommended that you leave river briefly before ending your trip at Montr茅al.
yeah and i you know i think defense really is what wins wins uh in the long run you can have the best half back there is or the best quarterback but if they don't have any blocking maybe they can't do anything	I think a good defense is the most important thing you need to win games.
Twelve days later, I made my second.	It took twelve days to make another.
and enjoy nature and uh kind of wipe out the stress of everyday life i'd always	I like to get out in nature and de-stress.
Mrs. Vandemeyer, she read, "20 South Audley Mansions.	20 South Audley Mansions is a book that Mrs. Vandemeyer read.
Traditionally a poor island, the native population has happily embraced the new seasonal lifestyle that has brought them proserity, and the old ways have almost completely disappeared.	The old ways of the native population has almost completely faded away.
a plausible increase in the penetration of computer ownership by households over the course of a single year.	Computer ownership by households usually increases in a year.
You and Tuppence have been sticking together like Siamese twins.	You and Tuppence have been hand in glove.
